Date,counts_trips,counts_Bike,trip_duration,counts_member_annual,counts_member_casual
2019-01-01,1064,674,1121463.0,897,167
2019-01-02,2290,1135,2838818.0,2207,83
2019-01-03,2279,955,1650338.0,2228,51
2019-01-04,3290,1381,2269606.0,3130,160
2019-01-05,2160,1053,1468872.0,1937,223
2019-01-06,1757,946,1265686.0,1595,162
2019-01-07,3037,1349,2198275.0,2971,66
2019-01-08,3560,1438,2339841.0,3493,67
2019-01-09,3532,1457,2505796.0,3470,62
2019-01-10,3067,1369,2384689.0,3011,56
2019-01-11,2663,1233,1823376.0,2611,52
2019-01-12,1690,924,1205567.0,1610,80
2019-01-13,1393,821,796742.0,1326,67
2019-01-14,3569,1507,2277018.0,3476,93
2019-01-15,3689,1483,2385738.0,3596,93
2019-01-16,3099,1348,1909551.0,3049,50
2019-01-17,3168,1360,1890443.0,3120,48
2019-01-18,2902,1230,1839373.0,2831,71
2019-01-19,558,382,1163832.0,549,9
2019-01-20,222,178,142877.0,218,4
2019-01-21,842,530,686654.0,835,7
2019-01-22,1655,847,1326640.0,1629,26
2019-01-23,1425,789,1002145.0,1407,18
2019-01-24,2428,1011,2210966.0,2370,58
2019-01-25,2401,1053,1450959.0,2324,77
2019-01-26,1205,661,1493268.0,1155,50
2019-01-27,356,263,252929.0,329,27
2019-01-28,580,426,798004.0,576,4
2019-01-29,356,255,599878.0,352,4
2019-01-30,573,363,1994818.0,567,6
2019-01-31,652,395,511190.0,651,1
2019-02-01,943,541,757367.0,916,27
2019-02-02,784,447,654447.0,712,72
2019-02-03,1106,577,827097.0,1024,82
2019-02-04,2682,1209,2117027.0,2627,55
2019-02-05,3123,1317,2487821.0,3071,52
2019-02-06,615,398,422995.0,606,9
2019-02-07,1482,751,1357423.0,1469,13
2019-02-08,1790,934,1088957.0,1774,16
2019-02-09,1024,606,589435.0,991,33
2019-02-10,1008,619,570186.0,974,34
2019-02-11,1965,989,3831355.0,1930,35
2019-02-13,572,357,2064677.0,563,9
2019-02-14,1467,757,1061671.0,1425,42
2019-02-15,1689,850,1169338.0,1649,40
2019-02-16,894,558,871227.0,842,52
2019-02-17,657,429,698216.0,630,27
2019-02-18,456,312,298644.0,439,17
2019-02-19,1965,973,1639657.0,1935,30
2019-02-20,2050,999,1825387.0,2024,26
2019-02-21,2429,1109,1837120.0,2391,38
2019-02-22,2729,1188,2234009.0,2625,104
2019-02-23,1581,851,1392029.0,1475,106
2019-02-24,936,554,555174.0,879,57
2019-02-25,1849,972,1102120.0,1818,31
2019-02-26,2340,1093,1539506.0,2304,36
2019-02-27,400,298,423333.0,391,9
2019-02-28,1207,669,1011170.0,1172,35
2019-03-01,1914,943,1392740.0,1871,43
2019-03-02,708,439,450319.0,673,35
2019-03-03,983,546,865474.0,936,47
2019-03-04,1832,908,2035905.0,1801,31
2019-03-05,1890,943,1195949.0,1887,3
2019-03-06,1981,964,1621817.0,1960,21
2019-03-07,2188,1044,2452345.0,2158,30
2019-03-08,2495,1175,1552591.0,2442,53
2019-03-09,1490,836,1003221.0,1400,90
2019-03-10,920,556,714638.0,858,62
2019-03-11,2682,1220,1629419.0,2600,82
2019-03-12,3323,1361,2246034.0,3196,127
2019-03-13,3307,1342,2655818.0,3228,79
2019-03-14,3208,1327,2163818.0,3080,128
2019-03-15,3522,1437,3099914.0,3317,205
2019-03-16,1813,917,1177178.0,1672,141
2019-03-17,1849,990,1828974.0,1616,233
2019-03-18,3762,1499,2630852.0,3558,204
2019-03-19,4010,1497,2864567.0,3805,205
2019-03-20,4836,1712,3688302.0,4596,240
2019-03-21,4439,1597,3914875.0,4239,200
2019-03-22,3425,1420,2263736.0,3302,123
2019-03-23,2565,1275,3041622.0,2039,526
2019-03-24,2765,1304,3228434.0,2080,685
2019-03-25,4189,1610,3011975.0,4031,158
2019-03-26,4477,1658,3005260.0,4228,249
2019-03-27,4987,1765,4073177.0,4629,358
2019-03-28,4364,1606,3143585.0,4167,197
2019-03-29,5605,1922,4603685.0,4981,624
2019-03-30,949,591,1150070.0,867,82
2019-03-31,1065,592,632172.0,983,82
2019-04-01,4219,1564,2802072.0,3976,243
2019-04-02,5007,1749,4505517.0,4640,367
2019-04-03,4762,1712,3675708.0,4572,190
2019-04-04,5129,1752,3811881.0,4824,305
2019-04-05,4132,1603,4688575.0,3890,242
2019-04-06,5366,1900,7016223.0,3447,1919
2019-04-07,4001,1558,5371355.0,2637,1364
2019-04-08,5891,1997,5911976.0,5088,803
2019-04-09,5384,1827,3799214.0,4981,403
2019-04-10,5449,1910,3973285.0,5143,306
2019-04-11,4140,1654,2733736.0,3986,154
2019-04-12,5236,1873,4893410.0,4700,536
2019-04-13,6522,2044,7368905.0,4177,2345
2019-04-14,1052,628,2406093.0,925,127
2019-04-15,4444,1668,4391534.0,4127,317
2019-04-16,5056,1758,3354482.0,4765,291
2019-04-17,6465,2035,4856696.0,5812,653
2019-04-18,6387,2035,5000204.0,5733,654
2019-04-19,1325,788,1199980.0,1124,201
2019-04-20,1420,824,1185228.0,1194,226
2019-04-21,4282,1694,5501868.0,2413,1869
2019-04-22,6839,2137,7799545.0,5068,1771
2019-04-23,6050,2022,4798264.0,5520,530
2019-04-24,6915,2148,6221317.0,6007,908
2019-04-25,7065,2117,6536947.0,6093,972
2019-04-26,3484,1420,2298283.0,3195,289
2019-04-27,3528,1485,2877504.0,2915,613
2019-04-28,5185,1804,8010956.0,3456,1729
2019-04-29,4383,1739,3148915.0,4049,334
2019-04-30,6033,2014,4453330.0,5474,559
2019-05-01,2980,1295,1919206.0,2830,150
2019-05-02,5631,1892,4430391.0,5148,483
2019-05-03,4425,1670,3403816.0,3947,478
2019-05-04,4589,1748,4995450.0,3195,1394
2019-05-05,8679,2226,12339642.0,4583,4096
2019-05-06,7565,2250,6851444.0,6436,1129
2019-05-07,7039,2019,5558437.0,6300,739
2019-05-08,7447,2197,5945096.0,6585,862
2019-05-09,4878,1826,3434100.0,4468,410
2019-05-10,6178,2003,5811517.0,5431,747
2019-05-11,6654,2044,9208331.0,4123,2531
2019-05-12,2322,1168,1917552.0,1875,447
2019-05-13,2313,1146,1536459.0,2218,95
2019-05-14,6480,2030,5925332.0,5862,618
2019-05-15,7133,2157,5991305.0,6146,987
2019-05-16,7353,2168,5973894.0,6421,932
2019-05-17,8592,2316,8390778.0,6588,2004
2019-05-18,6396,2015,7583098.0,3597,2799
2019-05-19,8106,2147,11545469.0,3704,4402
2019-05-20,6476,1930,8470394.0,3191,3285
2019-05-21,9379,2409,8217945.0,7533,1846
2019-05-22,7378,2166,5840572.0,6433,945
2019-05-23,8604,2335,7655325.0,7313,1291
2019-05-24,9508,2420,8986404.0,7466,2042
2019-05-25,4135,1627,4255332.0,2903,1232
2019-05-26,11501,2465,16791577.0,5489,6012
2019-05-27,10113,2525,9814397.0,7651,2462
2019-05-28,5926,1838,5012829.0,5213,713
2019-05-29,8036,2155,10343249.0,6952,1084
2019-05-30,9200,2314,8139313.0,7711,1489
2019-05-31,9600,2397,8655146.0,7320,2280
2019-06-01,7496,2149,7819704.0,4593,2903
2019-06-02,8858,2251,13772154.0,4874,3984
2019-06-03,8740,2359,7448335.0,7180,1560
2019-06-04,8084,2245,11475212.0,7196,888
2019-06-05,4772,1766,3659353.0,4337,435
2019-06-06,10154,2511,10031609.0,8117,2037
2019-06-07,11054,2583,13454861.0,8352,2702
2019-06-08,12579,2558,18847255.0,6021,6558
2019-06-09,10151,2327,14584019.0,4973,5178
2019-06-10,3936,1613,3014068.0,3321,615
2019-06-11,10717,2620,10967038.0,8631,2086
2019-06-12,10617,2574,10115455.0,8612,2005
2019-06-13,4702,1793,4911027.0,4078,624
2019-06-14,11303,2644,11813934.0,8493,2810
2019-06-15,7410,2200,7747203.0,4736,2674
2019-06-16,8862,2250,11121813.0,4709,4153
2019-06-17,12195,2779,16185481.0,8654,3541
2019-06-18,11552,2608,13051028.0,8929,2623
2019-06-19,11657,2662,12974738.0,9172,2485
2019-06-20,5856,1903,4907614.0,4904,952
2019-06-21,11716,2606,11899360.0,8610,3106
2019-06-22,12507,2543,17221666.0,5939,6568
2019-06-23,11390,2499,15715213.0,5475,5915
2019-06-24,10238,2522,9805575.0,7925,2313
2019-06-25,11552,2602,16569777.0,9013,2539
2019-06-26,10936,2565,10269049.0,8560,2376
2019-06-27,11672,2583,11373352.0,9052,2620
2019-06-28,9087,2414,8624869.0,6888,2199
2019-06-29,10316,2435,14213199.0,4706,5610
2019-06-30,11809,2535,18984754.0,4496,7313
2019-07-01,13412,2630,23944282.0,4887,8525
2019-07-02,10421,2635,10725868.0,8131,2290
2019-07-03,12331,2733,11827042.0,9418,2913
2019-07-04,12750,2766,12667672.0,9539,3211
2019-07-05,12401,2752,12428598.0,8719,3682
2019-07-06,9878,2422,12498558.0,5209,4669
2019-07-07,12293,2574,17813517.0,6090,6203
2019-07-08,12007,2805,13058297.0,9022,2985
2019-07-09,13035,2903,12231235.0,9905,3130
2019-07-10,13709,2967,13360121.0,10380,3329
2019-07-11,12429,2874,12474934.0,9714,2715
2019-07-12,13318,2946,13093576.0,9773,3545
2019-07-13,11396,2796,15685957.0,5878,5518
2019-07-14,13627,2826,19174711.0,6624,7003
2019-07-15,12410,2958,12232967.0,9419,2991
2019-07-16,11933,2925,11296080.0,9523,2410
2019-07-17,8365,2370,7820536.0,6509,1856
2019-07-18,13515,3054,20285183.0,10415,3100
2019-07-19,11709,2832,10454502.0,8982,2727
2019-07-20,10289,2618,14158716.0,5621,4668
2019-07-21,12441,2799,16713403.0,6121,6320
2019-07-22,11168,2836,9738316.0,8660,2508
2019-07-23,13696,3049,12821722.0,10577,3119
2019-07-24,14297,3102,14914144.0,10756,3541
2019-07-25,13279,3121,12683422.0,10164,3115
2019-07-26,14214,3157,15700988.0,10030,4184
2019-07-27,13135,2984,18374776.0,6404,6731
2019-07-28,11925,2808,15576316.0,6107,5818
2019-07-29,12703,3070,12329310.0,9635,3068
2019-07-30,9982,2626,9170164.0,7537,2445
2019-07-31,14168,3091,16346972.0,10674,3494
2019-08-01,14225,3070,15278997.0,10543,3682
2019-08-02,13208,2981,13834615.0,9136,4072
2019-08-03,12474,2921,20529633.0,5707,6767
2019-08-04,13668,2883,21556524.0,5467,8201
2019-08-05,12843,2877,18255675.0,5549,7294
2019-08-06,10284,2866,9064754.0,8378,1906
2019-08-07,17578,3342,19184866.0,10495,7083
2019-08-08,12916,3039,12334353.0,9949,2967
2019-08-09,13647,3090,14411529.0,9751,3896
2019-08-10,13775,2993,17762476.0,6576,7199
2019-08-11,13580,2979,19611671.0,6551,7029
2019-08-12,11473,2957,23273991.0,8447,3026
2019-08-13,14330,3178,14168898.0,10811,3519
2019-08-14,21243,3525,23987943.0,11029,10214
2019-08-15,13216,3047,11480580.0,9973,3243
2019-08-16,13953,3132,15136089.0,9823,4130
2019-08-17,9032,2601,14890426.0,4828,4204
2019-08-18,10409,2627,12896054.0,5475,4934
2019-08-19,13127,3026,15688421.0,9812,3315
2019-08-20,13321,3043,14213585.0,10403,2918
2019-08-21,18142,3341,18642993.0,10203,7939
2019-08-22,13943,3050,13982687.0,10300,3643
2019-08-23,13090,2953,12300756.0,9594,3496
2019-08-24,12799,2903,18583082.0,6223,6576
2019-08-25,12190,2770,18265424.0,5935,6255
2019-08-26,12825,3046,13313055.0,9473,3352
2019-08-27,8156,2339,8356022.0,6918,1238
2019-08-28,19027,3290,19061888.0,10294,8733
2019-08-29,13702,3045,14924105.0,10139,3563
2019-08-30,13003,2910,13550230.0,9354,3649
2019-08-31,12216,2740,16021967.0,5486,6730
2019-09-01,6608,2046,8279893.0,3409,3199
2019-09-02,11621,2648,16322063.0,5227,6394
2019-09-03,11551,2833,11471620.0,9416,2135
2019-09-04,12218,2931,10933268.0,10176,2042
2019-09-05,12644,2861,12575603.0,10341,2303
2019-09-06,10302,2706,9335264.0,8411,1891
2019-09-07,10565,2517,13418958.0,6390,4175
2019-09-08,9425,2380,11462758.0,5487,3938
2019-09-09,12030,2812,12541432.0,9400,2630
2019-09-10,12630,2763,10987774.0,10278,2352
2019-09-11,13183,2917,11439992.0,10316,2867
2019-09-12,12400,2783,10939400.0,9965,2435
2019-09-13,10842,2797,8901231.0,9068,1774
2019-09-14,11407,2763,13216382.0,6604,4803
2019-09-15,5325,1937,5298043.0,3810,1515
2019-09-16,10622,2853,9752695.0,9206,1416
2019-09-17,12694,3046,11016308.0,10721,1973
2019-09-18,12839,3093,11624014.0,10788,2051
2019-09-19,12930,3071,12785483.0,10732,2198
2019-09-20,12931,3011,12793765.0,10281,2650
2019-09-21,12485,2814,15741523.0,6764,5721
2019-09-22,10375,2557,12506851.0,6114,4261
2019-09-23,11204,2809,9752901.0,9381,1823
2019-09-24,12640,2904,10390130.0,10785,1855
2019-09-25,12351,2975,10635831.0,10612,1739
2019-09-26,10397,2606,9237779.0,9101,1296
2019-09-27,11881,2920,11150684.0,10095,1786
2019-09-28,6538,2211,6761959.0,4722,1816
2019-09-29,7545,2332,9674893.0,5239,2306
2019-09-30,10539,2809,9892091.0,9174,1365
2019-10-01,8951,2723,7044384.0,7970,981
2019-10-02,7548,2343,5383468.0,7009,539
2019-10-03,6330,2246,16520964.0,5912,418
2019-10-04,9642,2785,8473287.0,8435,1207
2019-10-05,7685,2474,8386187.0,5370,2315
2019-10-06,7039,2263,6877523.0,4989,2050
2019-10-07,10434,2860,8477755.0,9118,1316
2019-10-08,11050,2882,12509578.0,9798,1252
2019-10-09,10697,2855,8706016.0,9490,1207
2019-10-10,10698,2881,11601772.0,9515,1183
2019-10-11,10349,2825,8903604.0,8651,1698
2019-10-12,6347,2278,8558840.0,4214,2133
2019-10-13,6444,2171,8736520.0,3719,2725
2019-10-14,5315,2099,6718534.0,3442,1873
2019-10-15,9869,2843,9074200.0,8670,1199
2019-10-16,5794,1973,4630728.0,5351,443
2019-10-17,7795,2308,5514034.0,7193,602
2019-10-18,8926,2619,6915314.0,7817,1109
2019-10-19,7515,2426,9158186.0,5045,2470
2019-10-20,8672,2522,11568796.0,5348,3324
2019-10-21,9292,2664,6919571.0,8154,1138
2019-10-22,7007,2300,5260513.0,6345,662
2019-10-23,9422,2662,6846759.0,8466,956
2019-10-24,9286,2606,7150778.0,8274,1012
2019-10-25,8838,2582,9140558.0,7800,1038
2019-10-26,6234,2135,6642905.0,4439,1795
2019-10-27,3761,1629,3191230.0,3040,721
2019-10-28,9365,2579,7060897.0,8365,1000
2019-10-29,9555,2646,7119856.0,8641,914
2019-10-30,5233,2208,5749700.0,4921,312
2019-10-31,3564,1707,2484902.0,3415,149
2019-11-01,6359,2362,5409695.0,5959,400
2019-11-02,3730,1593,13190922.0,3262,468
2019-11-03,3957,1715,3348780.0,3206,751
2019-11-04,6667,2357,4729276.0,6246,421
2019-11-05,7458,2508,5560056.0,6908,550
2019-11-06,6581,2318,4455005.0,6177,404
2019-11-07,5557,2064,5003082.0,5261,296
2019-11-08,5821,2128,6330044.0,5445,376
2019-11-09,3371,1513,2361614.0,2937,434
2019-11-10,3400,1532,2614724.0,2901,499
2019-11-11,2102,1223,1456293.0,2012,90
2019-11-12,1716,907,1517189.0,1660,56
2019-11-13,2328,1222,1794363.0,2255,73
2019-11-14,3060,1411,2360569.0,2976,84
2019-11-15,4122,1750,2739494.0,3944,178
2019-11-16,2341,1228,1734018.0,2190,151
2019-11-17,2866,1417,3203342.0,2520,346
2019-11-18,3931,1713,3345703.0,3796,135
2019-11-19,5518,2050,4200080.0,5309,209
2019-11-20,6442,2301,4460020.0,6151,291
2019-11-21,5152,2074,3843040.0,4954,198
2019-11-22,5521,2105,3658977.0,5252,269
2019-11-23,3769,1642,3274994.0,3265,504
2019-11-24,3350,1532,2580683.0,2855,495
2019-11-25,6138,2197,5203437.0,5794,344
2019-11-26,7134,2370,5660807.0,6730,404
2019-11-27,4585,1810,3134277.0,4395,190
2019-11-28,5893,2146,14632993.0,5642,251
2019-11-29,5392,1996,3436020.0,5109,283
2019-11-30,3109,1444,7659360.0,2828,281
2019-12-01,517,387,330026.0,487,30
2019-12-02,1351,668,1085887.0,1319,32
2019-12-03,2709,1168,3659248.0,2636,73
2019-12-04,3734,1550,2957793.0,3611,123
2019-12-05,3973,1633,2842729.0,3881,92
2019-12-06,2276,949,1574176.0,2193,83
2019-12-07,2028,933,1667267.0,1948,80
2019-12-08,2124,1069,1483876.0,1978,146
2019-12-09,3771,1657,2591924.0,3696,75
2019-12-10,4579,1869,4384308.0,4444,135
2019-12-11,4008,1692,4541535.0,3915,93
2019-12-12,4115,1730,3142139.0,4006,109
2019-12-13,5003,1958,8853638.0,4821,182
2019-12-14,1108,702,902686.0,1050,58
2019-12-15,2043,1112,2335248.0,1920,123
2019-12-16,4605,1882,3265241.0,4395,210
2019-12-17,4475,1754,2946350.0,4319,156
2019-12-18,2844,1354,1800875.0,2788,56
2019-12-19,1990,1011,1523756.0,1927,63
2019-12-20,2769,1250,1970227.0,2639,130
2019-12-21,2136,1039,1497716.0,1920,216
2019-12-22,1979,1041,1834842.0,1787,192
2019-12-23,3377,1494,2440911.0,3132,245
2019-12-24,2225,1148,1707145.0,2015,210
2019-12-25,821,548,702802.0,589,232
2019-12-26,1278,761,982203.0,1135,143
2019-12-27,2588,1267,1916193.0,2205,383
2019-12-28,2503,1251,4743992.0,1982,521
2019-12-29,1027,622,955938.0,917,110
2019-12-30,2496,1223,1955258.0,2228,268
2019-12-31,1937,994,1190794.0,1795,142
2020-01-01,1358,795,1297550.0,1113,245
2020-01-02,3767,1631,3175672.0,3459,308
2020-01-03,4391,1757,3231056.0,3970,421
2020-01-04,2396,1184,1853778.0,2184,212
2020-01-05,1979,1073,1567695.0,1835,144
2020-01-06,3675,1566,2578630.0,3565,110
2020-01-07,4550,1791,3803320.0,4403,147
2020-01-08,3458,1447,2472075.0,3317,141
2020-01-09,3548,1555,2445571.0,3414,134
2020-01-10,4373,1768,3039634.0,4196,177
2020-01-11,825,568,848563.0,768,57
2020-01-12,1752,1030,1159938.0,1654,98
2020-01-13,4123,1652,2778077.0,4046,77
2020-01-14,4810,1883,3382340.0,4648,162
2020-01-15,5499,2100,3907425.0,5306,193
2020-01-16,4751,1893,3089963.0,4570,181
2020-01-17,3358,1566,2712989.0,3247,111
2020-01-18,544,401,2455634.0,515,29
2020-01-19,722,457,564040.0,689,33
2020-01-20,2039,1027,2040803.0,2002,37
2020-01-21,2735,1280,1993270.0,2674,61
2020-01-22,3381,1507,2550609.0,3275,106
2020-01-23,4020,1700,2727630.0,3895,125
2020-01-24,3406,1628,2996527.0,3312,94
2020-01-25,1715,915,1261674.0,1570,145
2020-01-26,1903,1052,1450272.0,1702,201
2020-01-27,4615,1938,3484889.0,4431,184
2020-01-28,4758,1874,3492570.0,4609,149
2020-01-29,4444,1862,2984921.0,4270,174
2020-01-30,4598,1841,3175290.0,4472,126
2020-01-31,4655,1829,3385293.0,4448,207
2020-02-01,2468,1248,2815009.0,2131,337
2020-02-02,1108,614,761784.0,1002,106
2020-02-03,5137,1980,3530405.0,4869,268
2020-02-04,5242,1974,3476665.0,5015,227
2020-02-05,4734,1906,3471553.0,4543,191
2020-02-06,2069,950,1442261.0,1925,144
2020-02-07,1823,870,1330441.0,1731,92
2020-02-08,1560,845,1792754.0,1344,216
2020-02-09,1590,883,1183746.0,1401,189
2020-02-10,3780,1596,2517168.0,3623,157
2020-02-11,4765,1845,3428578.0,4596,169
2020-02-12,4919,1908,3251831.0,4708,211
2020-02-13,3065,1312,2385570.0,2964,101
2020-02-14,2546,1270,4215858.0,2377,169
2020-02-15,1904,1038,1801456.0,1505,399
2020-02-16,2497,1222,2350311.0,1993,504
2020-02-17,2148,1109,2026411.0,1712,436
2020-02-18,3099,1448,2616679.0,2951,148
2020-02-19,4206,1747,2812287.0,4093,113
2020-02-20,4120,1722,2823964.0,3927,193
2020-02-21,4139,1730,3317435.0,3828,311
2020-02-22,3565,1606,3471250.0,2749,816
2020-02-23,4160,1739,4201169.0,2775,1385
2020-02-24,6176,2216,5749357.0,5392,784
2020-02-25,5403,1913,3936749.0,4687,716
2020-02-26,2891,1301,2172142.0,2541,350
2020-02-27,1687,810,1605041.0,1562,125
2020-02-28,2577,1197,2057863.0,2358,219
2020-02-29,1805,935,1423528.0,1423,382
2020-03-01,2477,1236,1880123.0,1828,649
2020-03-02,4094,1777,2961781.0,3904,190
2020-03-03,4016,1795,3038826.0,3820,196
2020-03-04,5551,2151,4225928.0,5190,361
2020-03-05,5908,2269,5457864.0,5329,579
2020-03-06,4639,1897,3304710.0,4301,338
2020-03-07,3770,1694,6804541.0,2789,981
2020-03-08,5407,2032,7745447.0,3378,2029
2020-03-09,7152,2572,7325260.0,6161,991
2020-03-10,4744,1848,3495298.0,4357,387
2020-03-11,5529,2002,4302424.0,5223,306
2020-03-12,5467,2095,3922757.0,5134,333
2020-03-13,4545,1791,3159648.0,4198,347
2020-03-14,3442,1568,3176543.0,2626,816
2020-03-15,3454,1561,3519081.0,2391,1063
2020-03-16,3400,1537,3087721.0,2922,478
2020-03-17,2744,1413,2253291.0,2349,395
2020-03-18,2369,1276,2357392.0,1970,399
2020-03-19,2633,1348,2999389.0,2132,501
2020-03-20,2300,1275,4649482.0,1852,448
2020-03-21,2655,1372,4109821.0,1759,896
2020-03-22,2014,1105,2829408.0,1460,554
2020-03-23,882,572,842807.0,799,83
2020-03-24,2101,1156,2053673.0,1806,295
2020-03-25,2214,1193,2923921.0,1711,503
2020-03-26,2153,1182,2411891.0,1646,507
2020-03-27,2817,1442,4928612.0,1989,828
2020-03-28,1398,825,1516438.0,1063,335
2020-03-29,2606,1303,4774244.0,1672,934
2020-03-30,1134,738,1700205.0,941,193
2020-03-31,1431,880,1258259.0,1252,179
2020-04-01,2665,1351,4425199.0,2006,659
2020-04-02,2723,1403,3466570.0,2029,694
2020-04-03,2039,1112,2006166.0,1624,415
2020-04-04,2734,1379,3998148.0,1850,884
2020-04-05,3920,1654,6469598.0,2289,1631
2020-04-06,2481,1308,3438016.0,1859,622
2020-04-07,2002,1135,2915133.0,1619,383
2020-04-08,2888,1467,4079555.0,2177,711
2020-04-09,1959,1092,1958539.0,1665,294
2020-04-10,1854,1075,3205153.0,1335,519
2020-04-11,3032,1515,4361829.0,2005,1027
2020-04-12,2313,1199,3081861.0,1571,742
2020-04-13,1091,712,1223017.0,921,170
2020-04-14,1704,1027,1529005.0,1450,254
2020-04-15,1639,977,1472417.0,1432,207
2020-04-16,1593,942,1397492.0,1380,213
2020-04-17,1797,1012,1977256.0,1576,221
2020-04-18,3963,1746,5483894.0,2448,1515
2020-04-19,1988,1090,3078387.0,1493,495
2020-04-20,2200,1213,3017297.0,1728,472
2020-04-21,1197,732,1800983.0,1098,99
2020-04-22,2169,1181,2499066.0,1777,392
2020-04-23,1792,1058,1533326.0,1552,240
2020-04-24,2385,1305,2608515.0,1916,469
2020-04-25,6509,2321,11793689.0,3256,3253
2020-04-26,1421,819,1483489.0,1037,384
2020-04-27,3641,1668,5459748.0,2436,1205
2020-04-28,2553,1324,2895431.0,1924,629
2020-04-29,1730,1014,1540603.0,1493,237
2020-04-30,1797,1036,1996446.0,1488,309
2020-05-01,4018,1806,5515581.0,2693,1325
2020-05-02,4238,1883,6175009.0,2349,1889
2020-05-03,13339,3300,26355496.0,4927,8412
2020-05-04,2914,1524,3716392.0,1999,915
2020-05-05,2995,1551,5344791.0,2132,863
2020-05-06,4103,1853,5539316.0,2693,1410
2020-05-07,2764,1455,5045230.0,2084,680
2020-05-08,2334,1337,3650730.0,1875,459
2020-05-09,1855,1052,1940914.0,1425,430
2020-05-10,2413,1314,3123417.0,1727,686
2020-05-11,1840,1048,1703478.0,1485,355
2020-05-12,2570,1379,2742245.0,2035,535
2020-05-13,4585,2019,7293329.0,3061,1524
2020-05-14,1932,1131,2043584.0,1552,380
2020-05-15,2764,1439,3372606.0,2049,715
2020-05-16,13742,3313,25820341.0,5362,8380
2020-05-17,6125,2306,10033094.0,2977,3148
2020-05-18,1416,821,1678336.0,964,452
2020-05-19,3483,1700,4570172.0,2597,886
2020-05-20,7223,2561,11178180.0,4102,3121
2020-05-21,7445,2614,18709731.0,4168,3277
2020-05-22,8884,2832,14926214.0,4345,4539
2020-05-23,20910,3780,39884287.0,6890,14020
2020-05-24,14320,3303,25144223.0,5466,8854
2020-05-25,8533,2721,14761483.0,4427,4106
2020-05-26,8744,2792,17991467.0,4879,3865
2020-05-27,8809,2766,14490084.0,4841,3968
2020-05-28,3417,1657,4660952.0,2381,1036
2020-05-29,4299,1895,8509358.0,3088,1211
2020-05-30,12040,3175,19475680.0,5113,6927
2020-05-31,12170,3101,19768592.0,5307,6863
2020-06-01,8168,2694,12720580.0,4609,3559
2020-06-02,6534,2393,11545407.0,4205,2329
2020-06-03,7436,2575,11074923.0,4607,2829
2020-06-04,9358,2853,13890643.0,5285,4073
2020-06-05,7634,2602,10837642.0,4654,2980
2020-06-06,18287,3564,31123149.0,7632,10655
2020-06-07,18381,3519,32581450.0,6736,11645
2020-06-08,9482,2814,13369562.0,5141,4341
2020-06-09,10895,3007,16665532.0,6027,4868
2020-06-10,8258,2748,10318269.0,4887,3371
2020-06-11,9442,2949,13652886.0,5541,3901
2020-06-12,10387,3017,14074267.0,5798,4589
2020-06-13,19097,3643,30671321.0,7236,11861
2020-06-14,17128,3542,35946955.0,6684,10444
2020-06-15,9470,2929,13352636.0,5552,3918
2020-06-16,10762,3123,16117379.0,6426,4336
2020-06-17,11666,3266,15957743.0,6852,4814
2020-06-18,11563,3220,15735988.0,6565,4998
2020-06-19,13228,3484,19546635.0,7114,6114
2020-06-20,20508,3935,33445253.0,8258,12250
2020-06-21,16843,3582,27390431.0,7150,9693
2020-06-22,9196,2974,11428889.0,5459,3737
2020-06-23,7129,2551,9264060.0,4642,2487
2020-06-24,10840,3241,14777562.0,6672,4168
2020-06-25,11648,3408,16491169.0,7112,4536
2020-06-26,13862,3698,19090219.0,7630,6232
2020-06-27,17596,3974,25071981.0,7963,9633
2020-06-28,20094,4068,30846726.0,8405,11689
2020-06-29,12325,3480,16222864.0,6905,5420
2020-06-30,13254,3481,17632279.0,7951,5303
2020-07-01,21373,4178,34699981.0,8356,13017
2020-07-02,12169,3504,16825032.0,7203,4966
2020-07-03,13881,3640,17927234.0,7662,6219
2020-07-04,19845,4052,31162704.0,8467,11378
2020-07-05,18804,4006,26906839.0,8043,10761
2020-07-06,12327,3483,14720885.0,7516,4811
2020-07-07,12854,3546,15964356.0,7907,4947
2020-07-08,11693,3452,14591655.0,7343,4350
2020-07-09,13065,3600,16186593.0,8294,4771
2020-07-10,13547,3590,16976287.0,8188,5359
2020-07-11,9335,3062,11827918.0,5486,3849
2020-07-12,19443,4054,27100889.0,8965,10478
2020-07-13,12482,3577,16322728.0,7829,4653
2020-07-14,14202,3665,16733194.0,8929,5273
2020-07-15,15076,3828,20445307.0,9346,5730
2020-07-16,8637,3020,9550949.0,5985,2652
2020-07-17,16443,4028,19994460.0,9577,6866
2020-07-18,22857,4417,32694939.0,9990,12867
2020-07-19,12740,3572,16771185.0,6751,5989
2020-07-20,13777,3734,16225244.0,8640,5137
2020-07-21,14567,3841,17582933.0,9158,5409
2020-07-22,8609,3016,8459528.0,5994,2615
2020-07-23,14793,3802,16729110.0,9566,5227
2020-07-24,16401,3954,20053419.0,9775,6626
2020-07-25,22538,4377,32440208.0,10672,11866
2020-07-26,18638,4069,25514108.0,8636,10002
2020-07-27,10807,3373,11137271.0,7204,3603
2020-07-28,13983,3789,15240727.0,9195,4788
2020-07-29,13541,3734,14746629.0,9028,4513
2020-07-30,14891,3833,16170412.0,9642,5249
2020-07-31,15566,4014,18587499.0,9381,6185
2020-08-01,21078,4393,29075627.0,9666,11412
2020-08-02,7908,2934,9357606.0,4299,3609
2020-08-03,12575,3603,16360810.0,6910,5665
2020-08-04,8151,2930,7601388.0,5967,2184
2020-08-05,15149,3995,16471448.0,9764,5385
2020-08-06,15073,3937,17171854.0,9712,5361
2020-08-07,16451,4098,18999398.0,10206,6245
2020-08-08,23442,4593,35337806.0,10942,12500
2020-08-09,19074,4290,26347557.0,9332,9742
2020-08-10,13051,3730,14266683.0,8647,4404
2020-08-11,13347,3757,14789819.0,9267,4080
2020-08-12,15357,3947,16674211.0,10038,5319
2020-08-13,15571,3887,17705835.0,10067,5504
2020-08-14,16894,3990,19130482.0,10217,6677
2020-08-15,23206,4363,31048710.0,10850,12356
2020-08-16,14512,3722,18351876.0,7678,6834
2020-08-17,10379,3210,10623421.0,7344,3035
2020-08-18,14353,3891,15138417.0,9573,4780
2020-08-19,16000,4099,18273603.0,10374,5626
2020-08-20,16476,4079,17355729.0,11075,5401
2020-08-21,16455,3941,17943044.0,10601,5854
2020-08-22,22863,4389,29246053.0,11113,11750
2020-08-23,19888,4111,25056562.0,10026,9862
2020-08-24,14309,3683,14661578.0,9642,4667
2020-08-25,15768,3898,16579792.0,10509,5259
2020-08-26,12301,3499,12019569.0,8322,3979
2020-08-27,14333,3709,15311248.0,10117,4216
2020-08-28,16632,3949,18779841.0,10897,5735
2020-08-29,18015,4087,21538542.0,9867,8148
2020-08-30,21406,4291,26276326.0,10697,10709
2020-08-31,14451,3776,14985375.0,9794,4657
2020-09-01,14475,3816,14167620.0,10121,4354
2020-09-02,15168,3950,13752834.0,9631,5537
2020-09-03,15212,3969,15636789.0,10435,4777
2020-09-04,16354,4036,17822401.0,10442,5912
2020-09-05,19757,4270,23991649.0,9302,10455
2020-09-06,23554,4510,30716697.0,9736,13818
2020-09-07,11797,3566,13962138.0,6413,5384
2020-09-08,11045,3390,9240508.0,8609,2436
2020-09-09,13798,3814,14350905.0,8530,5268
2020-09-10,13298,3750,12387299.0,9700,3598
2020-09-11,14103,3811,14309103.0,10333,3770
2020-09-12,19619,4347,24100460.0,10777,8842
2020-09-13,15077,3886,18260404.0,8551,6526
2020-09-14,11848,3596,10553229.0,9158,2690
2020-09-15,11881,3519,10229887.0,9386,2495
2020-09-16,17693,4301,18062298.0,10204,7489
2020-09-17,12683,3759,13613147.0,9360,3323
2020-09-18,12266,3568,10694833.0,9402,2864
2020-09-19,15859,4102,17935060.0,9494,6365
2020-09-20,15423,3930,18263269.0,9109,6314
2020-09-21,11012,3482,9963221.0,8693,2319
2020-09-22,11877,3555,10384685.0,9431,2446
2020-09-23,18411,4256,18048091.0,10343,8068
2020-09-24,11872,3445,10351958.0,8839,3033
2020-09-25,14588,3800,14063417.0,10578,4010
2020-09-26,20889,4387,25207202.0,11121,9768
2020-09-27,18502,4162,22377567.0,9762,8740
2020-09-28,11985,3518,10748489.0,9159,2826
2020-09-29,10718,3288,8935393.0,8671,2047
2020-09-30,9898,3017,8237923.0,6721,3177
2020-10-01,11177,3395,9142635.0,8522,2655
2020-10-02,10159,3186,8196561.0,8261,1898
2020-10-03,13316,3640,14240100.0,8694,4622
2020-10-04,5773,2287,4697284.0,4497,1276
2020-10-05,10146,3172,8599661.0,8228,1918
2020-10-06,10270,3263,8611061.0,8390,1880
2020-10-07,8647,2977,6892021.0,7159,1488
2020-10-08,8666,2827,7465603.0,7215,1451
2020-10-09,11814,3415,10233879.0,8992,2822
2020-10-10,13476,3613,15909852.0,8168,5308
2020-10-11,9130,3005,10582179.0,5781,3349
2020-10-12,8199,2829,9582246.0,5252,2947
2020-10-13,10293,3160,9800542.0,7880,2413
2020-10-14,10210,3130,9140153.0,7747,2463
2020-10-15,4469,1949,3311968.0,3725,744
2020-10-16,9954,3095,8353408.0,7725,2229
2020-10-17,13847,3682,15504774.0,8346,5501
2020-10-18,8703,2890,8563095.0,6060,2643
2020-10-19,4700,1972,3356936.0,4121,579
2020-10-20,8161,2748,6885002.0,6827,1334
2020-10-21,7916,2773,6398029.0,6308,1608
2020-10-22,7669,2641,6355168.0,6266,1403
2020-10-23,12120,3466,12195106.0,8631,3489
2020-10-24,10227,3185,10348476.0,6620,3607
2020-10-25,7068,2612,6457435.0,4982,2086
2020-10-26,6001,2358,5245010.0,4939,1062
2020-10-27,5036,2080,3756678.0,4082,954
2020-10-28,8595,2971,7439459.0,6800,1795
2020-10-29,6851,2551,5197299.0,5537,1314
2020-10-30,6629,2537,4978747.0,5231,1398
2020-10-31,8368,2955,8176132.0,5657,2711
2020-11-01,3797,1834,2919575.0,2981,816
2020-11-02,4571,1957,3303178.0,3785,786
2020-11-03,5998,2398,4439202.0,4945,1053
2020-11-04,8710,2949,7696907.0,6477,2233
2020-11-05,8732,2933,7587541.0,6674,2058
2020-11-06,10569,3253,9885381.0,7265,3304
2020-11-07,16703,3977,20511879.0,8449,8254
2020-11-08,15071,3763,19641887.0,7519,7552
2020-11-09,8978,2999,8482871.0,6286,2692
2020-11-10,11258,3239,11386433.0,7497,3761
2020-11-11,9656,2946,8416195.0,6722,2934
2020-11-12,7098,2463,5813299.0,5441,1657
2020-11-13,6851,2360,5592718.0,5341,1510
2020-11-14,8020,2642,8042082.0,5349,2671
2020-11-15,2697,1295,1886455.0,2150,547
2020-11-16,4811,1943,3425024.0,4015,796
2020-11-17,5067,1972,3810358.0,4113,954
2020-11-18,5113,1955,3556136.0,4188,925
2020-11-19,6866,2351,5291998.0,5460,1406
2020-11-20,9384,2757,8198019.0,6636,2748
2020-11-21,6679,2324,6057015.0,4762,1917
2020-11-22,1439,841,1044332.0,1152,287
2020-11-23,3276,1514,2367932.0,2635,641
2020-11-24,3832,1672,3002494.0,3065,767
2020-11-25,3467,1514,2563363.0,2773,694
2020-11-26,5000,1849,3813984.0,3961,1039
2020-11-27,5552,2046,4776648.0,4331,1221
2020-11-28,6267,2207,6357603.0,4209,2058
2020-11-29,5999,2128,7322651.0,3923,2076
2020-11-30,1795,1005,1749060.0,1521,274
2020-12-01,1961,901,1386144.0,1538,423
2020-12-02,3871,1539,3060476.0,3064,807
2020-12-03,4435,1684,3296585.0,3446,989
2020-12-04,3252,1354,2347625.0,2626,626
2020-12-05,4060,1696,3377096.0,3014,1046
2020-12-06,3691,1557,3053385.0,2622,1069
2020-12-07,3218,1476,2146567.0,2661,557
2020-12-08,3761,1545,2825654.0,3037,724
2020-12-09,2676,1201,1969625.0,2145,531
2020-12-10,4312,1684,3199034.0,3442,870
2020-12-11,5093,1946,3997362.0,3889,1204
2020-12-12,2358,1143,1811101.0,1733,625
2020-12-13,3562,1558,3031405.0,2686,876
2020-12-14,3503,1624,3017182.0,2783,720
2020-12-15,3345,1484,2243892.0,2620,725
2020-12-16,2501,1214,1672788.0,1971,530
2020-12-17,3051,1389,2110972.0,2450,601
2020-12-18,3790,1550,2838542.0,2833,957
2020-12-19,2935,1302,2414901.0,2297,638
2020-12-20,2972,1204,2450454.0,2255,717
2020-12-21,3789,1572,2853110.0,2877,912
2020-12-22,3735,1571,2945402.0,2854,881
2020-12-23,4196,1671,3214886.0,3127,1069
2020-12-24,2147,1053,1784322.0,1623,524
2020-12-25,666,333,784484.0,465,201
2020-12-26,993,461,1072739.0,706,287
2020-12-27,1613,752,1246182.0,1231,382
2020-12-28,2174,1070,1635699.0,1616,558
2020-12-29,2861,1374,2229515.0,2128,733
2020-12-30,1566,825,1144268.0,1146,420
2020-12-31,3188,1392,2403107.0,2298,890
2021-01-01,1795,960,1635228.0,1211,584
2021-01-02,1890,924,1587822.0,1308,582
2021-01-03,1937,882,1455294.0,1330,607
2021-01-04,3054,1336,2216692.0,2341,713
2021-01-05,2816,1249,1985146.0,2104,712
2021-01-06,3167,1366,2261736.0,2402,765
2021-01-07,3559,1523,2558888.0,2661,898
2021-01-08,3465,1450,2478131.0,2554,911
2021-01-09,4114,1687,3726511.0,2743,1371
2021-01-10,2942,1395,2548574.0,1976,966
2021-01-11,2941,1383,2240089.0,2140,801
2021-01-12,2755,1248,2019001.0,2109,646
2021-01-13,3505,1468,2546936.0,2571,934
2021-01-14,3473,1497,2645409.0,2504,969
2021-01-15,3072,1356,2253096.0,2244,828
2021-01-16,4636,1789,4304502.0,2915,1721
2021-01-17,3538,1555,2905132.0,2282,1256
2021-01-18,3075,1373,2906524.0,2281,794
2021-01-19,2983,1358,2056692.0,2214,769
2021-01-20,2651,1274,1904631.0,1934,717
2021-01-21,3298,1462,2447875.0,2364,934
2021-01-22,3050,1348,2406152.0,2170,880
2021-01-23,2586,1323,2337672.0,1761,825
2021-01-24,2458,1237,2149217.0,1734,724
2021-01-25,3228,1488,2493626.0,2330,898
2021-01-26,1046,674,780198.0,752,294
2021-01-27,1552,779,1220326.0,1110,442
2021-01-28,1678,850,1223197.0,1180,498
2021-01-29,2076,942,1593431.0,1468,608
2021-01-30,2390,1195,2194975.0,1575,815
2021-01-31,1438,850,1035387.0,1067,371
2021-02-01,2055,1012,1459014.0,1965,90
2021-02-02,2299,1127,1646739.0,2218,81
2021-02-03,2723,1311,2043390.0,2561,162
2021-02-04,3180,1431,2693569.0,2863,317
2021-02-05,2132,1069,1463497.0,1964,168
2021-02-06,1943,1023,1527033.0,1732,211
2021-02-07,1573,807,1152529.0,1432,141
2021-02-08,1917,980,1314368.0,1823,94
2021-02-09,2134,1031,1631986.0,2054,80
2021-02-10,2295,1086,1701169.0,2141,154
2021-02-11,2299,1155,2365908.0,2125,174
2021-02-12,1678,814,1156164.0,1561,117
2021-02-13,1376,779,982309.0,1250,126
2021-02-14,2067,1019,1770186.0,1676,391
2021-02-15,1489,793,1281626.0,1357,132
2021-02-16,708,447,620559.0,678,30
2021-02-17,1584,830,1255959.0,1485,99
2021-02-18,1277,689,957228.0,1155,122
2021-02-19,1141,579,888274.0,1065,76
2021-02-20,1745,867,1423204.0,1592,153
2021-02-21,1998,979,1659189.0,1679,319
2021-02-22,1265,632,998854.0,1155,110
2021-02-23,2212,1066,2059034.0,2055,157
2021-02-24,2872,1292,2408065.0,2660,212
2021-02-25,2946,1373,2271341.0,2710,236
2021-02-26,3490,1526,2776895.0,3005,485
2021-02-27,3934,1742,4137013.0,2995,939
2021-02-28,2547,1153,2449138.0,2101,446
2021-03-01,2138,1079,1455045.0,2032,106
2021-03-02,2539,1246,1906486.0,2372,167
2021-03-03,4016,1775,3743292.0,3443,573
2021-03-04,2895,1377,3101802.0,2656,239
2021-03-05,2977,1426,2221616.0,2658,319
2021-03-06,2900,1380,2514461.0,2394,506
2021-03-07,3671,1655,4062793.0,2859,812
2021-03-08,3499,1648,2742207.0,3111,388
2021-03-09,5327,2200,4980117.0,4368,959
2021-03-10,5745,2214,5576810.0,4595,1150
2021-03-11,4821,2032,4482812.0,3905,916
2021-03-12,4544,1988,3938837.0,3794,750
2021-03-13,5885,2353,6739416.0,4169,1716
2021-03-14,3039,1496,2711560.0,2339,700
2021-03-15,3262,1568,2424792.0,2894,368
2021-03-16,3405,1534,2448324.0,3153,252
2021-03-17,5206,2100,4592444.0,4367,839
2021-03-18,3861,1690,3001831.0,3430,431
2021-03-19,4640,1881,3814583.0,3967,673
2021-03-20,11142,3087,14341789.0,6036,5106
2021-03-21,9782,2961,12915844.0,5363,4419
2021-03-22,6674,2415,8560952.0,4955,1719
2021-03-23,7143,2471,7200415.0,5549,1594
2021-03-24,5954,2273,5493203.0,4908,1046
2021-03-25,8895,2827,9919480.0,6456,2439
2021-03-26,4407,1801,3441923.0,3740,667
2021-03-27,6988,2538,7622143.0,4879,2109
2021-03-28,2874,1334,2409232.0,2374,500
2021-03-29,4987,2052,4600552.0,4375,612
2021-03-30,8946,2890,9616857.0,6622,2324
2021-03-31,5235,2142,4653731.0,4451,784
2021-04-01,4211,1843,3279485.0,3808,403
2021-04-02,5177,2135,5580547.0,3734,1443
2021-04-03,5435,2138,5656535.0,3809,1626
2021-04-04,13411,3362,20178320.0,6155,7256
2021-04-05,7021,2580,7473799.0,5001,2020
2021-04-06,6658,2483,6467835.0,5384,1274
2021-04-07,8714,2858,8446517.0,6682,2032
2021-04-08,10053,3106,11142586.0,6954,3099
2021-04-09,8125,2746,8161746.0,6069,2056
2021-04-10,19924,3971,29340504.0,9195,10729
2021-04-11,4823,2091,5077747.0,3049,1774
2021-04-12,3057,1481,2593610.0,2648,409
2021-04-13,7373,2640,7443215.0,5702,1671
2021-04-14,8994,2985,9950349.0,6475,2519
2021-04-15,5228,2186,4865838.0,4319,909
2021-04-16,5506,2156,5662199.0,4510,996
2021-04-17,9995,3007,12758884.0,6113,3882
2021-04-18,10541,3052,15208111.0,5868,4673
2021-04-19,2589,1495,2836382.0,2226,363
2021-04-20,4628,2073,4060672.0,3912,716
2021-04-21,3189,1494,2827674.0,2750,439
2021-04-22,4325,1833,3558475.0,3797,528
2021-04-23,11292,3411,13994122.0,7402,3890
2021-04-24,17964,4010,25342352.0,8672,9292
2021-04-25,9369,3088,11329345.0,5210,4159
2021-04-26,5886,2433,6316059.0,4402,1484
2021-04-27,6248,2531,6169150.0,4884,1364
2021-04-28,6203,2438,6298396.0,4848,1355
2021-04-29,3133,1549,2624829.0,2656,477
2021-04-30,5227,2319,4509160.0,4432,795
2021-05-01,12258,3642,15997922.0,7171,5087
2021-05-02,9264,3194,11179976.0,5569,3695
2021-05-03,4387,2074,3918975.0,3553,834
2021-05-04,5025,2197,5332806.0,4149,876
2021-05-05,6753,2721,7012741.0,5343,1410
2021-05-06,9407,3253,10175831.0,6531,2876
2021-05-07,7678,2897,7583817.0,5794,1884
2021-05-08,14017,3762,19167173.0,7594,6423
2021-05-09,11156,3420,14761787.0,5985,5171
2021-05-10,6958,2722,7049416.0,5318,1640
2021-05-11,6323,2628,5688121.0,5050,1273
2021-05-12,11983,3671,13864434.0,8056,3927
2021-05-13,12614,3728,15640490.0,8097,4517
2021-05-14,13583,3831,16591960.0,8590,4993
2021-05-15,24640,4549,37702755.0,11260,13380
2021-05-16,27029,4679,44860555.0,11077,15952
2021-05-17,12939,3628,16931999.0,8077,4862
2021-05-18,14784,3807,19251184.0,9292,5492
2021-05-19,14163,3741,17914664.0,8948,5215
2021-05-20,14153,3829,16938695.0,9439,4714
2021-05-21,18009,4185,23783276.0,10619,7390
2021-05-22,20183,4243,28765202.0,9383,10800
2021-05-23,24376,4650,40618731.0,10266,14110
2021-05-24,26023,4776,44679558.0,10278,15745
2021-05-25,12572,3675,14390343.0,8457,4115
2021-05-26,9986,3250,10198094.0,7126,2860
2021-05-27,12549,3691,13654874.0,8209,4340
2021-05-28,3625,1640,3121798.0,2845,780
2021-05-29,20048,4354,27731219.0,9480,10568
2021-05-30,24493,4611,36371881.0,10278,14215
2021-05-31,13045,3717,14402902.0,8267,4778
2021-06-01,13931,3881,16295135.0,9700,4231
2021-06-02,13612,3823,16330684.0,9287,4325
2021-06-03,10649,3425,11670198.0,7676,2973
2021-06-04,15918,3984,19056994.0,10348,5570
2021-06-05,27346,4740,41267658.0,12216,15130
2021-06-06,24439,4592,38146721.0,11300,13139
2021-06-07,13208,3732,14333312.0,9222,3986
2021-06-08,9714,3238,9918528.0,7315,2399
2021-06-09,15111,3876,16538750.0,10926,4185
2021-06-10,15833,3981,18805110.0,11013,4820
2021-06-11,15849,4037,16759999.0,10951,4898
2021-06-12,25334,4657,35084506.0,13079,12255
2021-06-13,19601,4266,26312764.0,10058,9543
2021-06-14,9102,3108,8325231.0,7200,1902
2021-06-15,14095,3828,14060418.0,10683,3412
2021-06-16,14023,3792,13708130.0,10590,3433
2021-06-17,14812,3922,15539447.0,11183,3629
2021-06-18,10099,3243,9861797.0,7673,2426
2021-06-19,20174,4395,25407677.0,11514,8660
2021-06-20,19506,4351,26482713.0,11049,8457
2021-06-21,10777,3370,10012999.0,8463,2314
2021-06-22,12651,3655,12658500.0,9896,2755
2021-06-23,14086,3838,14491923.0,10662,3424
2021-06-24,14818,3923,14506113.0,11155,3663
2021-06-25,8110,2949,7139034.0,6252,1858
2021-06-26,14698,3827,17652959.0,9032,5666
2021-06-27,20068,4323,26021412.0,11469,8599
2021-06-28,13130,3707,13541207.0,9754,3376
2021-06-29,7943,2856,6572038.0,6665,1278
2021-06-30,14010,3847,13713129.0,10822,3188
2021-07-01,18281,4167,23322516.0,9733,8548
2021-07-02,11390,3514,11931300.0,7652,3738
2021-07-03,20472,4352,26355855.0,10196,10276
2021-07-04,18931,4258,24476984.0,10251,8680
2021-07-05,12871,3621,12272254.0,9580,3291
2021-07-06,13404,3765,12791044.0,10162,3242
2021-07-07,13457,3774,12097919.0,8560,4897
2021-07-08,7177,2749,6844369.0,5635,1542
2021-07-09,11287,3453,10613519.0,8164,3123
2021-07-10,23320,4519,29001875.0,12681,10639
2021-07-11,11095,3415,12911150.0,6855,4240
2021-07-12,13145,3697,12701977.0,9788,3357
2021-07-13,11236,3442,10222051.0,8650,2586
2021-07-14,20678,4450,21287064.0,11362,9316
2021-07-15,12344,3651,11223698.0,8979,3365
2021-07-16,14883,3878,15010443.0,10533,4350
2021-07-17,11170,3359,11296664.0,6986,4184
2021-07-18,18529,4167,23258734.0,10177,8352
2021-07-19,13280,3718,13467370.0,9529,3751
2021-07-20,11721,3495,10805897.0,8857,2864
2021-07-21,22212,4531,23506719.0,11802,10410
2021-07-22,15867,4003,16583251.0,10885,4982
2021-07-23,16871,4050,18591006.0,11215,5656
2021-07-24,11488,3422,12272282.0,7247,4241
2021-07-25,18631,4101,21935755.0,10209,8422
2021-07-26,13887,3766,13837463.0,9687,4200
2021-07-27,10911,3377,9540767.0,8251,2660
2021-07-28,22178,4510,21861703.0,11319,10859
2021-07-29,11769,3588,11089869.0,8157,3612
2021-07-30,16142,4039,17110064.0,10633,5509
2021-07-31,15283,3907,16782519.0,8361,6922
2021-08-01,13929,3777,16601924.0,7524,6405
2021-08-02,19762,4259,25321753.0,9308,10454
2021-08-03,14811,3877,15339204.0,10017,4794
2021-08-04,16841,4094,16292482.0,11266,5575
2021-08-05,16320,4025,15630418.0,10927,5393
2021-08-06,16551,4039,17263951.0,10847,5704
2021-08-07,15978,4026,17234527.0,8976,7002
2021-08-08,17520,4122,20176201.0,9442,8078
2021-08-09,13812,3768,13059609.0,9640,4172
2021-08-10,12420,3514,11145225.0,8866,3554
2021-08-11,14342,3842,13294454.0,9819,4523
2021-08-12,14383,3791,13541576.0,9837,4546
2021-08-13,15131,3835,14070439.0,9938,5193
2021-08-14,21300,4434,25253951.0,10532,10768
2021-08-15,19261,4311,23783492.0,9730,9531
2021-08-16,13834,3774,13230728.0,9160,4674
2021-08-17,14576,3844,13540283.0,9955,4621
2021-08-18,14779,3820,12876925.0,10393,4386
2021-08-19,16433,3972,15900004.0,10908,5525
2021-08-20,16898,3992,15976659.0,10653,6245
2021-08-21,19988,4245,23691162.0,10226,9762
2021-08-22,17755,4029,21770701.0,9180,8575
2021-08-23,14394,3656,13678249.0,9361,5033
2021-08-24,15699,3856,15159359.0,10609,5090
2021-08-25,15142,3697,13716188.0,10321,4821
2021-08-26,13960,3618,13076639.0,9432,4528
2021-08-27,17403,3960,17050554.0,10816,6587
2021-08-28,17927,4074,20069396.0,9451,8476
2021-08-29,15453,3864,16181519.0,8462,6991
2021-08-30,14520,3795,13477535.0,9837,4683
2021-08-31,15821,3937,14733960.0,10740,5081
2021-09-01,16208,3914,15419944.0,10730,5478
2021-09-02,16127,3958,15346141.0,10686,5441
2021-09-03,16199,3906,15518561.0,10031,6168
2021-09-04,20267,4228,24598162.0,9302,10965
2021-09-05,18787,4108,23228238.0,8388,10399
2021-09-06,16979,3951,21210239.0,7841,9138
2021-09-07,11924,3550,10182477.0,8396,3528
2021-09-08,15111,3777,20731845.0,10646,4465
2021-09-09,14611,3780,12851074.0,10522,4089
2021-09-10,15666,3877,15354413.0,10665,5001
2021-09-11,18814,4200,19977262.0,10232,8582
2021-09-12,13480,3644,13755177.0,8005,5475
2021-09-13,14058,3712,11974003.0,9972,4086
2021-09-14,14442,3728,11676103.0,10484,3958
2021-09-15,15282,3877,13181006.0,10909,4373
2021-09-16,16260,3886,14032250.0,11373,4887
2021-09-17,17005,3887,16478410.0,11363,5642
2021-09-18,20555,4197,22954933.0,10775,9780
2021-09-19,18089,4030,20422512.0,9405,8684
2021-09-20,14965,3705,12886478.0,10164,4801
2021-09-21,11853,3265,9625856.0,8589,3264
2021-09-22,4952,2083,3409450.0,3805,1147
2021-09-23,12145,3355,9389794.0,8998,3147
2021-09-24,14479,3629,11757400.0,9984,4495
2021-09-25,12768,3574,12227047.0,7831,4937
2021-09-26,15932,3943,17308727.0,8544,7388
2021-09-27,13227,3594,11368109.0,9334,3893
2021-09-28,14666,3716,11871496.0,10285,4381
2021-09-29,14937,3780,12397686.0,10375,4562
2021-09-30,15000,3763,12712871.0,10234,4766
2021-10-01,15832,3875,14065922.0,5977,9855
2021-10-02,19347,4270,21792133.0,5853,13494
2021-10-03,7472,2664,6194618.0,2750,4722
2021-10-04,9184,2775,6826706.0,3833,5351
2021-10-05,13451,3532,10292366.0,5327,8124
2021-10-06,14380,3731,12195095.0,5853,8527
2021-10-07,14271,3584,11292636.0,5697,8574
2021-10-08,14291,3641,13047459.0,5412,8879
2021-10-09,8694,2962,8687510.0,3037,5657
2021-10-10,13607,3679,15967008.0,3719,9888
2021-10-11,14973,3860,17429391.0,4148,10825
2021-10-12,14669,3815,12271188.0,5481,9188
2021-10-13,15127,3862,12679168.0,5784,9343
2021-10-14,14972,3784,13036247.0,5658,9314
2021-10-15,10470,3227,8177232.0,3924,6546
2021-10-16,10346,3262,9473176.0,3787,6559
2021-10-17,11783,3554,12363942.0,4022,7761
2021-10-18,11467,3401,9552385.0,4486,6981
2021-10-19,14159,3743,11220517.0,5458,8701
2021-10-20,12972,3576,10007106.0,4969,8003
2021-10-21,10253,3153,7680082.0,3999,6254
2021-10-22,11827,3436,9336317.0,4450,7377
2021-10-23,11567,3480,10575392.0,3966,7601
2021-10-24,11784,3593,11905244.0,3844,7940
2021-10-25,4514,2048,3336114.0,1736,2778
2021-10-26,5962,2274,3821412.0,2371,3591
2021-10-27,13682,3704,10941264.0,5191,8491
2021-10-28,11327,3329,8185909.0,4447,6880
2021-10-29,8714,2926,6229217.0,3207,5507
2021-10-30,5796,2263,4086342.0,2162,3634
2021-10-31,10255,3270,9029333.0,3394,6861
2021-11-01,9551,3144,6823451.0,3702,5849
2021-11-02,9474,3112,7335350.0,3694,5780
2021-11-03,9539,3082,6926467.0,3579,5960
2021-11-04,9615,3031,7244102.0,3750,5865
2021-11-05,10249,3126,8120182.0,3832,6417
2021-11-06,10546,3249,10557070.0,3513,7033
2021-11-07,11672,3412,12073621.0,3584,8088
2021-11-08,10520,3263,9720937.0,3863,6657
2021-11-09,8154,2915,6026632.0,3208,4946
2021-11-10,10749,3226,8662108.0,3903,6846
2021-11-11,10377,3129,8128652.0,3698,6679
2021-11-12,10254,3151,7909161.0,3791,6463
2021-11-13,8691,2930,7831108.0,2876,5815
2021-11-14,3883,1869,3294129.0,1377,2506
2021-11-15,7703,2641,5378021.0,2841,4862
2021-11-16,8716,2865,6046869.0,3220,5496
2021-11-17,8059,2661,6767443.0,3009,5050
2021-11-18,8735,2782,6041264.0,3094,5641
2021-11-19,8994,2888,7116678.0,3258,5736
2021-11-20,7901,2816,9865856.0,2722,5179
2021-11-21,5886,2375,4673085.0,2062,3824
2021-11-22,7030,2672,4725730.0,2488,4542
2021-11-23,7862,2727,5541219.0,2835,5027
2021-11-24,8318,2790,5670595.0,3086,5232
2021-11-25,6284,2344,4291610.0,2258,4026
2021-11-26,6943,2512,4695273.0,2509,4434
2021-11-27,6306,2396,4791523.0,2282,4024
2021-11-28,1759,991,1285518.0,617,1142
2021-11-29,4151,1584,2897701.0,1413,2738
2021-11-30,5007,2008,3456550.0,1775,3232
2021-12-01,7068,2486,4867646.0,5580,1488
2021-12-02,6887,2445,4880857.0,5341,1546
2021-12-03,7212,2488,5038226.0,5600,1612
2021-12-04,5869,2299,5829404.0,4235,1634
2021-12-05,4131,1845,2955704.0,2987,1144
2021-12-06,4907,1976,3046727.0,3907,1000
2021-12-07,5771,2161,3771621.0,4577,1194
2021-12-08,3825,1509,2852714.0,3046,779
2021-12-09,4908,1836,3353531.0,3850,1058
2021-12-10,6683,2263,5302337.0,5102,1581
2021-12-11,5674,2156,4322684.0,4022,1652
2021-12-12,5556,2198,4421268.0,3801,1755
2021-12-13,6691,2437,4929438.0,5079,1612
2021-12-14,6718,2368,4826481.0,5094,1624
2021-12-15,5815,2033,4160878.0,4480,1335
2021-12-16,6882,2362,5227680.0,5236,1646
2021-12-17,6984,2371,5850059.0,5188,1796
2021-12-18,1874,1018,1522688.0,1408,466
2021-12-19,2568,1037,1970182.0,1863,705
2021-12-20,3984,1622,2897842.0,2963,1021
2021-12-21,4706,1923,3588239.0,3482,1224
2021-12-22,3633,1652,2780784.0,2721,912
2021-12-23,3723,1668,2696122.0,2687,1036
2021-12-24,2740,1309,1987443.0,1913,827
2021-12-25,1647,877,1584605.0,976,671
2021-12-26,2656,1354,2286257.0,1655,1001
2021-12-27,1265,756,955753.0,873,392
2021-12-28,3054,1466,2356616.0,2025,1029
2021-12-29,3521,1668,2896184.0,2440,1081
2021-12-30,4065,1785,2938443.0,2836,1229
2021-12-31,4832,1973,4279555.0,3186,1646
